3
1
9	5	6	8	3	7	4	2	1	
8	7	4	2	1	6	9	5	3
3	2	1	4	9	5	6	7	8	
6	9	5	3	7	4	1	8	2	
7	3	2	9	8	1	5	6	4	
4	1	8	6	5	2	7	3	9	
5	8	7	1	4	3	2	9	6	
1	6	3	5	2	9	8	4	7	
2	4	9	7	6	8	3	1	5	
